**Doktora Tamamlanmış Tezleri**

**2020**
- Gökhan Göksu: Zaman gecikmeli ve anahtarlamalı doğrusal sistemlerin sonlu zaman denetimi
- Nazlı Doğan: DN ve Ω özelliğine sahip nükleer Frechet uzaylarının kuvvet serisi alt uzayları
- Soner Aydınlık: Klasik ve mikrogermeli ortam teorisiyle modellenen plakların Caputo kesirli türevi yardımıyla nonlokal titreşim analizi

**2019**
- Araniyos Terefe Weldegebriel: Sosyal ağların dengelenmesi
- Cem Sayar: Kapsamlı submersiyonlar
- Elif Erçelik: Olasılık yoğunluk fonksiyonu tahmini üzerine
- Furkan Göktaş: Portföy seçiminde temel bileşenler analiziyle yeni dayanıklı ve bulanık modeller: Teori ve uygulamalar
- Mustafa Deniz Türkoğlu: Özel koneksiyona sahip Weyl uzaylarının geometrisi
- Vural Bayrak: Lineer olmayan bazı dalga denklemlerin çözümlerinin patlaması üzerine

**2018**
- Ekin Deliktaş: Tabakalı bazı ortamlarda nonlineer dalga yayılması probleminin asimptotik analiz
- Özlem Orhan: Matematiksel fizikteki bazı problemlerin simetri grup sınıflandırmaları
- Sinem Güler: Özel yarı-Einstein manifoldları
- Tuğba Yıldırım: Yerel kohomoloji ve radikal olarak mükemmel idealler

**2017**
- Ayşın Erkan Gürsoy: Simetrik grupların temsil teorisi
- Burcu Bektaş: Sonlu tipten alt manifoldlar ve Gauss tasvirleri
- Dilek Demirkuş: Heterojen bir tabakada nonlineer SH dalgaları
- İzzet Göksel: Kübik-kuintik ortamlarda kafes solitonları

**2016**
- Bahar Kırık: Bazı özel manifoldlar üzerinde vektör alanları
- Mahmut Bağcı: Davey Stewartson sisteminde temel kafes solitonları
- Pegah Mutlu: Pseudö simetrik lokal olarak konform Kaehler manifoldları
- Rüya Şen: Hiperbolik ve yarı-hiperbolik uzaylarda sonlu tipten genelleştirilmiş Gauss tasvirine sahip alt manifoldlar
- Selçuk Kayacan: Sonlu grupların kesişim çizgeleri

**2015**
- Burhaneddin İzgi: Matematiksel finanstaki stokastik diferansiyel denklemlerin davranışsal sınıflandırması
- Erdoğan Şen: Diferansiyel operatörlerin düzenli izleri ve spektral özellikleri

**İletişim Bilgileri**
- Telefon: +90 (212) 285 32 53
- Fax: +90 (212) 285 63 86
- Adres: İTÜ Ayazağa Kampüsü, 34469, Maslak, İstanbul